type octile
height 31
width 30
map
.@...@@....
...@.@..@..
@@@@.@.@@@@
..@........
.@@.@@@@@@.
..@.@...@..
@.@.@.@.@.@
@...@@@.@..
..@.....@@.
.@@@@.@..@.
......@@...
